xxxxxxxxxxxxxxx
x.............x
x.x.x.x.x.x.x.x
x.............x
x.x.x.x3x.x.x.x
x.....0.1.....x
x.x.x.x2x.x.x.x
x.............x
x.x.x.x.x.x.x.x
x.............x
xxxxxxxxxxxxxxx
